FFFFFFFFFFFFFFFFFFF
0000000WWWW0WWW0000
00WWWWWWFFWWWFW0000
00WFFWFFFIFFIIW0000
00WFFFFFFFWWFFW0000
00WFWWWFFFFFFFWW000
00WFWBWWWWWIIIFW000
00WIFFFFFFFIFFWW000
00WFWFWWFMFIIIW0000
WWWFWFWFFFFFFIW0000
WKWFWTWFFFFIIIW0000
WIWFWFWWWWWIFWWWWW0
WIWFIFWEFHFIWWFPFW0
WIWWIWWWWWWFFFIFFW0
WIIIIW0000WWWWWWWW0
WWWWWW0000000000000
FFFFFFFFFFFFFFFFFFF