FFFFFFFFFFFFFFFFFFF
0000000000000000000
0000000000000000000
0WWWWWWWWWWWWWWW000
0WFFFFFFFFFFFFFW000
0WFWWWWWWWWWWWFWWWW
0WFWWWEFFFFFFFIFFFW
0WFWWWWWWWWWWWFWWFW
0WFWWWWWWWWWWWPWWFW
0WFWWWWWWWWWWWWWWFW
0WFWWFFFFWWMFWWWWFW
0WFFFFFFFFFFFFFFFFW
0WWWWWWWFFFFFFWWWWW
0000000WWWWWWWW0000
0000000000000000000
0000000000000000000
FFFFFFFFFFFFFFFFFFF