FFFFFFFFFFFFFFFFFFF
0000000000000000000
0000000000000000000
0000000000000000000
WWWWW000WWWWW000000
WFFFWWWWWFFFW000000
WFWFWWPWWFWFW000000
WFFIFFIFFIFFWWWW000
WWWFWWFWWFWWWWEW000
0WWFWWFWWFWWWWFWW00
0WFFFFIFFIFFWWFFW00
0WMFFWFWWFWFWFFFW00
0WFFFFFWWFFFWFWWW00
0WFWWWWWWWWWWFFFW00
0WFFFFFFFFFFFFFFW00
0WWWWWWWWWWWWWWWW00
FFFFFFFFFFFFFFFFFFF