FFFFFFFFFFFFFFFFFFF
00000000000000WWW00
00000000000000WEW00
000000000000WWWFWWW
00WWWWWWWWWWWIFIFIW
00WFFFFFFFFWWIWFWIW
00WFFFWWWWFFWFFIFFW
00WFFFFIFWFFWWWFWWW
0WWWIFWFFWFFIFWFWWW
0WFFIWWWFWWWFWWHWWW
0WFWFFKWFFFFFWFIIIW
0WFWFWFWIWFFFWFWWIW
0WFFIWFWIWFFFWFPWIW
0WWWFFIIFWFFFWWWWIW
000WFFWFMWFFIIIIIIW
000WWWWWWWWWWWWWWWW
FFFFFFFFFFFFFFFFFFF