FFFFFFFFFFFFFFFFFFF
0000000000000000000
0000000000000000000
0000000000000000000
0000000000000000000
0000000000000000000
0000000000000000000
0000000000000WWW000
0000000000000WPW000
000WWWWWWWWWWWFWWW0
0WWWFFFFFFFFFFFFFW0
0WEFFFFFFMFFFFFFFW0
0WWWWFFFFFFFFFFFFW0
0000WWWWWWWWWWWWWW0
0000000000000000000
0000000000000000000
FFFFFFFFFFFFFFFFFFF