FFFFFFFFFFFFFFFFFFF
0000000000000000000
0000000000000000000
0000000000000000000
0000000000000000000
0000000000000000000
0000000000000000000
0000000000000000000
00WWW00000000WWW000
00WEW0000WWWWWPW000
00WFWWWWWWFFWWFW000
00WFFFFFFFFFFFFW000
00WFFWWFFWWWWFFW000
00WWWWWWWW00WWWW000
0000000000000000000
0000000000000000000
FFFFFFFFFFFFFFFFFFF