FFFFFFFFFFFFFFFFFFF
WWWWWWWWWWWWWWWWWWW
WWKFFFFFFFFFFFFFFMW
WBFFFFFFFFFFFFF1FFW
WWWWWFFFIFFFFFFFFFW
WWWWWFW2IFFFFFFFWFW
WWWPFFWFIFFFFFFFFFW
WWWWWWWFFFFFFFFWFFW
WWWEFFWFFFFFFFFWFFW
WWWWWHWFFFFFFFFFFFW
WWWWWIIFFFWFFFFFWFW
WFFFIFFFFFWFFFFFTFW
WFWWIFWFFFFFFFFFFFW
WFWWIIFFFFFFFFFFWFW
WFFFIFWWFFWWFFWFFFW
WWWWWWWWWWWWWWWWWWW
FFFFFFFFFFFFFFFFFFF