FFFFFFFFFFFFFFFFFFF
0000000000000000000
0000000000000000000
0000000000000000000
0000000000000000000
0000000000000000000
0000000000000000000
0000000000000WWW000
00000WWWWWWW0WEW000
00000WFFMFFW0WFW000
0WWWWWFWWWFWWWFW000
0WPFFFFW0WFFFFFW000
0WWWWWWW0WWWWWWW000
0000000000000000000
0000000000000000000
0000000000000000000
FFFFFFFFFFFFFFFFFFF